Jy%%%%%%%%%
y%%%%%%%%%%
%%%%%%%%%%y
%%%%%%%%%%y
%%%%%%%%%%S
%%%%%%%%%%%
D%A%%%%%%%S
%%%%%%%%%%y
%S%%%%%%%%y
b%S%%%%%%%%
2b%%B%B%%%%