RRR%%%RRR%R
RRRRRRR%RRR
%R%%R%%%R%R
RRR%R%SRR%R
RRRRR%D%R%R
%R%%R%%%R%%
RRR%R%U%R%R
%R%%RRBRR%R
RRR%%R%%R%R
RRR%RRR%RRR
RRRRRRR%R%R