XXXXXSDXXXX
XXXXXRXXXXX
XXXXXRXXXXX
XXXX%R%XXXX
XXX%%R%%XXX
XXX%%R%%XXX
XXX%%B%%XXX
XXX%%U%%XXX
XXXX%%%XXXX
XXXXXXXXXXX
XXXXXXXXXXX