RRRSDXUBRRR
RXXXXXXXXXR
RXX%%%%%XXR
RX%%R%R%%XR
RX%%R%R%%XR
RX%%R%R%%XR
RXX%R%R%XXR
RXX%R%R%XXR
RXXXRRRXXXR
RXXXXRXXXXR
RRRRRRRRRRR