%%%%%%%%%%%
%%%%%%%%%%%
%%%%%%%%%%%
%%%%%%%%%%%
%%S%D%D%S%%
%%S%%%%%S%%
%%%%%%%%%%%
%%%%A%A%%%%
%%%%%%%%%%%
%%%%y%y%%%%
%%%%%%%%%%%