RRR%RRR%RRR
R%R%RRR%R%R
R%R%%R%%R%R
R%R%RRR%R%R
R%R%RRR%R%R
R%R%%R%%R%R
R%R%RRR%R%R
R%R%RRR%R%R
R%R%%R%%R%R
B%R%RRR%R%S
U%RRRRRRR%D
