%q%%%%%%%q%
%%%%%%%%%%%
%%%%%%%%%%%
%%k%DFD%k%%
b%%%%D%%%%b
b%%%%%%%%%b
h%%%mwm%%%h
%%%%%m%%%%%
%%%%%%%%%%%
%%%%%%%%%%%
%%%%%%%%%%%