%!u%%%%%%%!
%u%%%%%%%%%
%%%!%%%%%%!
%%%%%%%%%%%
%%%%%!%%%!%
%%%!%%%%%%%
%%%%%%%!%!%
%u%%%%%%%%%
%!u%#%%!%%!
%%%%%%%%%%%
%%#%%%%%%%!
