%%%%%%ADyr%
%%D%B%ADyb%
%%y%y%ADy%%
%%y%y%%%%%%
%%%%%%%%%%%
%%%%%%%%%%%
%%%%%%%%%%%
%%%%%%%%%%%
%%y%BS%%%%%
%%y%BS%%%%%
%%A%BS%%%%%