D%RRR%RRRR%
S%R%R%RRRR%
R%R%R%RRRR%
R%R%R%%%%R%
R%R%RRRRRR%
R%R%%R%%R%%
RRRRRR%RRR%
R%R%%R%R%R%
R%R%RR%R%R%
B%R%RR%R%R%
U%R%RR%R%R%