k%%%B%%%%yb
%%%%%%%%%%y
%%%%%%%%%%%
%%%%4%%%%%%
%%%%%%%%%%%
A%%%%%%%%%%
D%%%%%%%%%%
%%%%%%%%%%%
%%%%%%%%%%%
%%%%%%%%%%%
%%%%%%%%%%%