R%R%RRRRRRR
R%R%RRRRRRR
R%R%RR%%R%%
RRR%RR%RRRR
R%R%%%%RRRR
R%RRRRRRRRR
R%%R%%%%RRR
RR%R%RRRRRR
%%%R%R%R%R%
RR%R%R%RRB%
DSRRRR%R%U%