%%%%%c%%c%%
%%%%c%%%%c%
D%%%s%%%%%%
%%%%%s%%ms%
D%%%%%%%%%s
%%%%%%k%%%%
%%%%%%%%%%%
%%%%%%%%mw%
%%%%%%%%%%%
%%%%%%%%%%%
%%%%%%%%%%%