%%%%%%%%%%%
%%%%%%%%%%%
%%%%%%%%%%%
B%%%%%%%%%%
%%%%%%%%A%%
%%%%%%%%A%%
%%%%%%%%A%D
%%%%%%%%%%D
D%%%%%%%%%D
%%%%B%%%%%%
%%%%%%%W%%%