RRRRRRR%RRR
R%%%%%R%R%R
R%RRRRR%R%R
R%R%%%R%R%R
R%RRR%R%R%R
R%RRR%R%R%R
R%RRR%R%R%R
R%%%%%R%R%R
RRR%RRRRR%R
%%R%R%%%%%R
DSRRBU%RRRR