1%y%%%%%%%%
%y%%%%%%%%%
y%%%%%%%%%%
%%%%%%%%y%%
%%%%%%%%y%%
%%%%%%%%y%%
%%%%%%%%%%%
%%%%%%%%%%%
%%%%%%%%%%%
%%%%%%D%y%%
%%%%%%ABy%%