RRR%FsT%%%%
RRR%RRR%RRR
RRR%%R%%R%R
%R%%RRR%R%R
RRR%%%R%R%R
R%RRRRR%R%R
R%%%%%RRR%R
RRRRR%%R%%R
%%%%R%RRR%R
%RRRR%RRR%B
DS%%%%RRR%U