%h%%%%%%%%%
h%%%%%%%%b%
%k%%%%%%%%%
%%%%%k%%%%h
%%%%%%%%%%b
l%%bhb%%%%h
l%%%%%%%%%%
%%%%%%%%%%%
%%%%b%h%h%%
%%%%%%%b%%%
%%%%%%%%%%%