%%%D%%%A%%%
%%%%%%%%%%%
%%%%%%%%%%B
%%%%%%%%%%%
%%%%yyy%%%y
%%%%%%%%%%y
%%%%%%%%%%%
%%%%%%%%%%%
%%SDA%%%%%y
%%SDA%%%%%y
%%SDA%b%b%S
