%o%%%%%%%$%
%%%%%%%%%%%
%%%%%%%%%%%
%%%%%%%%%%%
j%%%$%n%%%%
g%%u%%p%%%%
j%$%%%n%%%%
%%%%%%%%%%%
%g%%%%%$%%%
%%%%%%%%%%%
%%%%%%%%u%%
