%%y%%%%%%%%
%%%%%%%%%%%
S%%%%%SyS%%
y%A%%%SyS%%
%%%%%%%%%%%
y%%%%%%%%%%
D%b%%%%%%%%
%%%%%%%%%%%
%%%%%%%%%%%
SBy%r%%%y%b
SLy%%%%%yyy
