S%y%b%r%B5B
S%y%b%r%%%%
S%y%b%r%%%%
%%%%%%%%%%%
%%%%%%%%%%%
%%%%%%%%%%%
D%%%B%B%%%A
D%%%%%%%%%A
D%%%%%%%%%A
%%%%S%S%%%%
%%%%%%%%%%%