R%R%R%R%RRR
R%R%R%R%RRR
R%R%R%R%RRR
R%R%R%R%%R%
RRRRR%RRRRR
R%%R%%%R%%R
R%RRRRRRR%R
R%R%%%%%R%R
R%R%FsT%R%R
%%R%RRR%R%%
DSRRRRRRRBU