UBRRRRRR%%%
%%RR%R%RR%%
%RRR%R%RRR%
RR%%%R%%%RR
RRRRRRRRRRR
R%%%%R%%%%R
R%RR%R%RR%R
R%RR%R%RR%R
R%%RRRRR%%R
RR%%%R%%%RR
%RRRDSRRRR%