%%%%%%%%%%%
%%%F%%%Z%%%
%%F%%Y%%Z%%
%%%%%%%%%%%
%%%Y%%%Y%%%
%%%%%%%%%%%
%%%%%Y%%%%%
%%%%%%%%%%%
%%%%%%%%%%%
%%%%%%%%%%%
%%%%%%%%%%%