XXXXXXXXXXX
XXRRXRXRRXR
XRRXXRXXRRX
XXRRXRXRRRX
XXRRRRRRRXX
XXRRRSRRRXX
XXXRRXRRXXX
XXXXRDRXXXX
XXXXXXXXXXX
XXXXXXXXXXX
XXXXXXXXXXX