w%%D%y%c%BB
%y%A%%y%%%B
y%%%%%%y%%%
%%%%%%%%%%%
%%%%%%%%%%%
%%%%yyy%%%%
%%%%%%%%%%%
%%%%%%%%%%%
%%%%%%%%%%%
%%%%%%%%%%%
%%%%%%%%%%%