RR%R%RRR%RR
RR%R%RRR%RR
RRRRRRRR%RR
RR%R%RRR%RR
%%%R%%%%%R%
RRRRRRRRRRR
R%%%%%%%%%%
R%RRRRRRRR%
R%R%R%%%%R%
R%R%BR%%RS%
RRR%URRRRD%