%%%%gjg%%%%
%%%%%%%%%%%
%%%%%j%%%%%
%o%%%%%%%!%
o$%%%%%%%@!
%%%%%%%%%%%
%%%%%%%%%%%
%%%%%%%%%%%
%o%nnpnn%o%
%%%%%%%%%%%
%%%%%%%%%%%
