%%%%%%%%%%%
%%%%%%%%npn
%%%%%%%%%n%
%%%%%%%%%%%
%%%%%%%%%%%
%%%%%%%%%%%
%%%n%o%n%%%
%%i%%%%%i%%
%%i%%%%%i%%
%%%%%%%%%%%
%%%%%%%%%%%
