%%%%%%%%%%%
%%%%%%%%%%%
%%%D%%%%%%%
%%%%%%%%%%%
%%%%%C%%%%%
%%%%%%%%%%%
%%SD%%%AS%%
%%yS%%%Sy%%
%%%bbBbb%%%
%%%%%%%%%%%
%%%%%%%%%%%
