%RRRUBRRRR%
%RR%%%%%RR%
%R%%%%%%%R%
%R%%%R%%%R%
%R%%%R%%%R%
%RR%%R%%RR%
%RXX%R%XXR%
%RXX%R%XXR%
%RXX%R%XXR%
%RRRRSRRRR%
%%%%%D%%%%%