%%!%%%%%%%%
%%%%%%%%%%%
%%%%%%%%%%%
%%%%%%%%%%%
%%%%%%%%%%%
%%%%%$%%%%%
%%%%%u%%%%%
%%%%%$%%%%%
%%%%%%%%%%%
%npn%%%npn%
%%%%%%%%%%%