XRRRRRRRRRR
XRXXXXXXXXR
XRXRRRRRRRR
XRXRXXXXXXX
XRXRXRRRRRX
XRXRRRXXXRX
XRXXXXXRRRX
XRXXXDXRXXX
XRRRRSXRRRR
XXXXXXXXXXR
UBRRRRRRRRR