%XXXXUXXXX%
%XXXXBXXXX%
%XXXXRXXXX%
%XXXXRXXXX%
%XXXXRXXXX%
%XXXXRXXXX%
%%XXXRXXX%%
%%%%%R%%%%%
M%M%RRR%M%M
MMMMMSMMMMM
MMMMMRMMMMM