RR%RRRRR%RR
RR%R%R%R%RR
RR%R%R%R%RR
RR%R%R%R%RR
RR%R%R%R%RR
%R%R%R%R%R%
RRRR%R%RRRR
%%%R%%%R%%%
RRRRRRRRRRR
%%%%%R%%%%%
UBRRRRRRRSD