%A%S%r%S%A%
B%y%b%b%y%B
%D%%%%%%%D%
S%y%%%%%y%S
%b%%%%%%%b%
r%%%%%%%%%r
%b%%%%%%%b%
S%y%%%%%y%S
%D%%%%%%%D%
B%y%b%b%y%B
%A%S%r%S%A%