RRRRRRRRRRR
RXRXRXRXRXR
XRRRRRRRRRX
RXRXRDRXRXR
RRRRRSRRRRR
RXRXRXRXRXR
RRRRRBRRRRR
RXRXRURXRXR
XRRRRRRRRRX
RXRXRXRXRXR
RRRRRRRRRRR