#%Y%$%$%Y%#
%%%%%%%%%%%
%%Y%u%u%Y%%
%%%%%%%%%%%
$%u%%%%%u%$
%%%%%%%%%%%
$%u%%%%%u%$
%%%%%%%%%%%
%%Y%u%u%Y%%
%%%%%%%%%%%
#%Y%$%$%Y%#