XXXXXXXXXXX
XXXXXXXXXXX
XXXXXXXXXXX
XXXX%%%XXXX
XXX%%R%%XXX
XXX%%R%%XXX
XXX%%R%%XXX
XXXX%R%XXXX
XXXXXXXXXXX
XXXXXXXXXXX
DSRRRRRRRRR