R%%RR%RR%%R
RR%%R%R%%RR
RRRRR%RRRRR
R%R%%%%%R%%
R%RRRRRRR%R
R%R%%%%R%%R
R%RRSD%RRRR
R%%%%%%R%%R
R%RRR%RRR%R
B%RRRRR%R%R
U%RRR%R%R%R