%%%%i%i%%%%
%%%%%%%%%%v
%%%%%%%%%v%
%%%%%%%%%%%
D%%%%%%%%%%
F%%%%%%%%%%
D%%%%%%%%F%
%%%%%%%%%%%
%%%%%%%F%%%
%%%%%%e%e%%
%%%%%%%%%%%