D%RRRR%RRRR
S%R%%R%R%%R
R%R%RRRRR%R
R%R%R%%%R%R
R%R%R%UBR%R
R%R%R%%%%%R
R%R%RRR%RRR
R%R%%%R%R%%
R%RRR%R%RRR
R%%%R%R%%%R
RRRRR%RRRRR