%%%%%%%%%Z%
%%%%%%%%%%%
%%%%%%%%%%%
%%%%e%%%D%q
D%%%%%%%%%q
F%%%%%%%%%%
D%q%%%%%%F%
%%q%%%w%%%%
%%%Z%%Z%%%%
%%%%%%%%%%%
%%e%%%%aYa%