%Z%%%%a%%%%
Z%%%%%%a%t%
%F%%%F%%%%t
%%%w%%%%%v%
%%%%%%%%%%%
%%x%%%%%x%%
%%%%%%%%%%%
%%%%%%%%%%%
%%%%%%%%%%%
%%%%%%%%%%%
%%%%%%%%%%%
