UBRRRRRRRRR
%%%%%%%%%%R
RRRRR%RRR%R
RRR%R%RRR%R
%R%%R%%%R%R
RRR%RRRRR%R
RRR%R%%%%%R
%R%%RRRRRRR
RRR%%R%%%R%
RRR%RSR%RRR
RRR%RDR%RRR