%%%lhl%%%%%
%%%%%%%%%%%
%%k%%%%%%%%
%k%%%%%%%%%
%%%%%%%%q%%
%s%%%%clb%%
%%%%%%%%%%%
%%%%%%%%%%%
%s%%%%%%%%%
%%%%%%%%%m%
%%%%%%%%%%%