RRRRRRRRRRR
RXRXXXXXRXR
RXRXXXXXRXR
RXRXXUXXRXR
RXRXXBXXRXR
RXRXXRXXRXR
RXRXXRXXRXR
RXRXXRXXRXR
RXXXXRXXXXR
RXXXXRXXXXR
RRRRRRRRRSD